11111111111111111111111111111111111111111111
10X00000010000000C110C100000C0CCC0000CC00001
1001C1C0C000000C0000C00000100C001000000100C1
100C0000100C100C0C10110CC0100000000000C00001
10X0C000C11010X000C0X00CC101C0C0C01C0C00CC01
10000000CC0000XC000000C0C0011001000C01000C01
1X1C10X00C001C000000001C0C001C0010100001C001
10000CX00001C0000000C00101000000101000000001
1X000X0110010000C001000001010C00000X0000C001
11010C000CC0100CC0C01C0XC10000000C00000C00C1
101C00000000X00C1XCX00XC00000001C010C1000011
10X01000C01000C00110000C0C000C0XXC0000C000X1
1000C1C00000CCX00C000111000000000CC000CC1101
100X0001C0C00C0000C01C0C0000C0010C1000010001
100X000C00P00C00CXC00C0C010C0100000XC0000C01
100C01C000C10C100CC000C0C00C01000C000C0C0101
100000C00CC000001C01X0CCC0000CC10100001000C1
1001CC1000010000000C00CX01C0C00C000010000001
110CC0001C001C1C000100010000000C0CCC00000101
100C0100100X1000C00C0000C100CCC10100001000C1
100000001000C0010000C00010100010000C010C1C01
100000100C00X000000010000X0000000000CC000C01
1000000C000010C00100CXC0C0C0001000000000CX01
100C0001C0C0010000000C00110C0X00001X00000001
1X0000X010E001000000CCX0C0X00000CC0C001100C1
10CXC00000C000X001110C010CC101000CC000010C01
10000CC0001000C00CX0X0000C0C000X000010000C01
10000C10000000000010000C00000000010C000000C1
10X001CC0000CX0000X0C0C10010000C01CC100CX011
100XX00C0CC01C0C1CX000C000C000000C00000C0011
11111111111111111111111111111111111111111111
