11111
1P101
1CXC1
1E101
11111
