11111
1P001
1C0C01
1E101
11111